[
	[900, 500, 1300, 500],
	[1700, 500, 1820, 500, 1940, 500, 2060, 500, 2180, 500],
	[1100, 225],
	[800, 225],
	[850, 225, 950, 225, 1000, 225, 1050, 225, 1150, 225, 1200, 225, 1250, 225,
	 1350, 225, 1400, 225, 1450, 225, 1500, 225, 1600, 225, 1650, 225, 1700, 225,
	 1750, 225, 1800, 225, 1850, 225, 1900, 225, 1950, 225, 2000, 225, 2050, 225,
	 2100, 225, 2150, 225, 2200, 225, 2250, 225, 2300, 225, 2350, 225, 2400, 225]
]

